NO ./textures/north.png
SO ./textures/south.png
WE ./textures/west.png
EA ./textures/east.png
F 190,230,245
C 204,255,255

1111111111111111111111111111111111111111111111111111111111111111111111111111111111111111111111111111
1000000000N1000000000000000000000000000000000000000000000000000000000000000000000000000000000000001
1011000001110000000000000000000000000000000000000000000000000000000000000000000000000000000000000001
1001000000000000000000000000000000000000000000000000000000000000000000000000000000000000000000000001
1111111111111111111111111111111111111111111111111111111111111111111111111111111111111111111111111111