
F 190,230,245
C 204,255,255
NO ./assets/textures/north.png
SO ./assets/textures/south.png
WE ./assets/textures/west.png
EA ./assets/textures/east.png
111111111111111111111111111111111111111111111
1000000000N1000000000001
101100000111000000000001
100100000000000000000001
111111111111111111111111